 1  1  1  1 18  0  1 19  0  0 
 0  1  1  1  0  0  0  1  0  1 
23  0  1  1  0  0  1  1  0  1 
 1  1  0  0  1  0  0  0  0 10 
 1  1  0  0  1  1  0  0 14  0 
 1  1  1  0  0  0  1 25  1 13 
 0 15  1  0  0  1  0  1 24  0 
 0 17 17 17  1 30  0  4  0  0 
 1 17 26 17  0  0  0  0  0  0 
 0 17 17 17  0  1  1 12  0 22 
27  1  0  8  1  1  1  0  1  0 
 0  1  1  1  1  1  0  0 28  1 
 6  1 31  0  1  0  1  0  1  1 
 1  0  1  0  0  0  1  1  1  2 
 1  0  1  1 11  1  1  0  1  0 
 0  0  1 29 16  0  0  0  0  7 
 1  0 20  0  1  1  0  1  9  0 
 3  0  1  0  0  1  1  0  1  0 
 0  0  0 21  5  0  0  0  0  0 
 0  0 32  0  0  0  0  1  0  0 
